teamID	teamIDretro
ANA	ANA
BAL	BAL
BOS	BOS
CHA	CHA
CLE	CLE
DET	DET
KCA	KCA
MIN	MIN
NYA	NYA
OAK	OAK
SEA	SEA
TBA	TBA
TEX	TEX
TOR	TOR
ARI	ARI
ATL	ATL
CHN	CHN
CIN	CIN
COL	COL
FLO	FLO
HOU	HOU
LAN	LAN
MIL	MIL
MON	MON
NYN	NYN
PHI	PHI
PIT	PIT
SDN	SDN
SFN	SFN
SLN	SLN
LAA	ANA
WAS	WAS
MIA	MIA
CHA	CHN
CHN	CHA
